{
    "0, 0": {
      "chunk": [
      [1, 2, 2, 2, 2, 2, 2, 2],
      [4, 5, 5, 5, 5, 5, 5, 5],
      [4, 5, 5, 5, 5, 5, 5, 5],
      [4, 5, 5, 5, 5, 5, 5, 5],
      [4, 5, 5, 5, 5, 5, 5, 5],
      [4, 5, 5, 5, 5, 5, 5, 5],
      [4, 5, 5, 5, 5, 5, 5, 5],
      [4, 5, 5, 5, 5, 5, 5, 5]
    ]
  },
  "1, 0": {
      "chunk": [
      [2, 2, 2, 2, 2, 2, 2, 2],
      [5, 5, 5, 5, 5, 5, 5, 5],
      [5, 5, 5, 5, 5, 5, 5, 5],
      [5, 5, 5, 5, 5, 5, 5, 5],
      [5, 5, 5, 5, 5, 5, 5, 5],
      [5, 5, 5, 5, 5, 5, 5, 5],
      [5, 5, 5, 5, 5, 5, 5, 5],
      [5, 5, 5, 5, 5, 5, 5, 5]
    ]
  },
  "2, 0": {
      "chunk": [
      [2, 2, 2, 2, 2, 2, 2, 2],
      [5, 5, 5, 5, 5, 5, 5, 5],
      [5, 5, 5, 5, 5, 5, 5, 5],
      [5, 5, 5, 5, 5, 5, 5, 5],
      [5, 5, 5, 5, 5, 5, 5, 5],
      [5, 5, 5, 5, 5, 5, 5, 5],
      [5, 5, 5, 5, 5, 5, 5, 5],
      [5, 5, 5, 5, 5, 5, 5, 5]
    ]
  },
  "3, 0": {
      "chunk": [
      [2, 2, 2, 2, 2, 2, 2, 3],
      [5, 5, 5, 5, 5, 5, 5, 6],
      [5, 5, 5, 5, 5, 5, 5, 6],
      [5, 5, 5, 5, 5, 5, 5, 6],
      [5, 5, 5, 5, 5, 5, 5, 6],
      [5, 5, 5, 5, 5, 5, 5, 6],
      [5, 5, 5, 5, 5, 5, 5, 6],
      [5, 5, 5, 5, 5, 5, 5, 6]
    ]
  }
}
